0: #ffe51b
1: #2b2e34
2: #3bb5e6
3: #ffffff
4: #4c63b3
5: #a96eb6
6: #e83d71
7: #ee2c28
8: #ff542d
9: #ff8939

000000000000111000000000000111011111000000000000000000
000000000001222111000000001222122222101100000000000000
000000000001122222111100001222232222312210000000000000
000000000014411222222211111122333223332210000000000000
000000000011444112222222222222313223132100000000000000
000000000155114441122222222222232222321000000000000000
000000000115551144412222222222222222222111000000000000
000000001661155511412222222222222112222222111000000000
000000001166611555122222222222222222222222222111000000
000000017711666115122222222222222222222222222222111000
000000011777116661222222222222223322222222222222222110
000000188117771161222222222222223322222222211111222221
000000118881177712222222222222222222222222144444111110
000001991188811712222222222222222222222221111114444410
000000199911888122222222222222222222222215555551111100
000000011999111222222222222222222222222111111155555100
000000000111222222222222222222222222221666666611111000
000000011222222222222222222222222222211111111666661000
000000122222222222222222222222222222177777777111110000
000000111111111111111122222222222221111111117777710000
000001444444444444444122222222222221888888881111100000
000001111111111111111222222111222222111111188888100000
000015555555555555512222222144112222219999911111000000
000011111111111111122222222114441122221111999991000000
000166666666666661222222222151144411222100111110000000
000111111111111112222222222155511444112210000000000000
001777777777777712222222222111555114441100000000000000
001111111111111122222222222166115551144100000000000000
018888888888888122222222222116661155511000000000000000
011111111111111122222222222171166611551000000000000000
199999999999991122222222221177711666110000000000000000
011111111111111412222222221811777116610000000000000000
000000000000011412222222211888117771100000000000000000
000000000000115141122221119118881177100000000000000000
000000000000115144411114119991188811000000000000000000
000000000001161511444411101199911881000000000000000000
000000000001161555111151000011999110000000000000000000
000000000011716115555111000000119910000000000000000000
000000000011716661111610000000001100000000000000000000
000000000118171166661110000000000000000000000000000000
000000000118177711117100000000000000000000000000000000
000000000191811777711100000000000000000000000000000000
000000000191888111181000000000000000000000000000000000
000000000019118888111000000000000000000000000000000000
000000000019991111910000000000000000000000000000000000
000000000001199991100000000000000000000000000000000000
000000000000011110000000000000000000000000000000000000